11111111111111111111
10C100010C010C010E01
10010000000010110001
10000C01001000010001
101100010000P0000101
11111111111111111111