111111
1P0001
100C01
100001
1E0001
111111